01 01 03 01 01 03 01 01 01 01 01 02 01 15 01 01 
01 00 00 00 00 00 00 01 00 00 00 00 00 00 00 01 
01 00 00 00 00 00 00 01 00 00 00 00 00 00 00 01 
01 00 00 00 00 00 00 01 00 00 00 00 00 00 00 01 
01 00 00 00 00 00 00 00 00 00 00 00 00 00 00 04 
01 00 00 00 00 00 00 00 00 00 00 00 00 00 00 04 
01 00 00 00 00 00 00 00 00 00 00 00 00 00 00 04 
01 00 00 00 00 00 00 01 00 00 00 00 00 00 00 05 
01 00 00 00 00 00 00 01 00 00 00 00 00 00 00 01 
01 00 00 00 00 00 00 01 00 00 00 00 00 00 00 01 
01 01 01 05 10 01 01 01 01 01 01 01 01 01 01 01 