01 03 03 01 18 18 01 01 01 05 20 05 05 10 01 01 
01 00 00 00 00 00 00 00 00 00 00 00 00 00 00 01 
19 00 00 00 00 00 00 01 00 00 00 00 00 00 00 01 
19 00 00 00 00 00 00 01 00 00 00 00 00 00 00 01 
01 00 00 00 00 00 00 01 00 00 00 00 00 00 00 01 
01 00 01 01 01 01 01 01 01 01 01 01 01 01 00 01 
01 00 00 00 00 00 00 01 00 00 00 00 00 00 00 01 
01 00 00 00 00 00 00 01 00 00 00 00 00 00 00 01 
01 00 00 00 00 00 00 01 00 00 00 00 00 00 00 01 
01 00 00 00 00 00 00 00 00 00 00 00 00 00 00 01 
01 01 17 02 15 16 01 01 01 05 04 04 04 05 05 01 