01 05 20 10 05 01 05 04 04 04 05 01 02 15 16 01 
01 00 00 00 00 01 00 00 00 00 00 01 00 00 00 01 
03 00 00 00 00 01 00 00 00 00 00 01 00 00 00 01 
01 00 00 00 00 01 00 00 00 00 00 01 00 00 00 01 
03 00 00 00 00 01 00 00 00 00 00 01 00 00 00 01
01 00 00 00 00 01 00 00 00 00 00 01 00 00 00 01 
18 00 00 00 00 01 00 00 00 00 00 01 00 00 00 01 
01 00 00 00 00 00 00 00 00 00 00 00 00 00 00 01 
18 00 00 00 00 00 00 00 00 00 00 00 00 00 00 01 
01 00 00 00 00 00 00 00 00 00 00 00 00 00 00 01 
01 01 01 01 01 01 01 01 01 01 01 01 01 01 01 01 